     XXXX




 XXXX    XXXX




XXXXXXXXXXXXXX
XXXXXXXXXXXXXX
 XXXXXXXXXXXX
  XXXXXXXXXX
   XXXXXXXX
    XXXXXX
     XXXX